xxxxxxxxxxxxxxx
x         #  bx
x#xxxxxxx     x
x #           x
x  #     x    x
x   #         x
x          x  x
x     x       x
x     #    x  x
x     x   xx  x
x  x  x       x
x     x  x    x
x     x    x# x
xa          x#x
xxxxxxxxxxxxxxx