xxxxxxxxxxxxxxx
x #      3   bx
x # xx    x   x
x # x         x
x   x#  x  x  x
x    2  ###   x
x  #       #  x
x   xxx       x
x            #x
x  xxxxx x    x
x#    1  # x  x
x  xx       4 x
x       x # # x
xa  #      #  x
xxxxxxxxxxxxxxx