xxxxxxxxxxxxxxx
x  ##    x  #bx
x   xx    x   x
x  #   2   x  x
x          x  x
x  xxxx  #    x
x           # x
x   ##   3x   x
x 1   #   x   x
x   x     #   x
x   x #  xxxx x
x   x       4 x
x   #  xxxx   x
xa         ## x
xxxxxxxxxxxxxxx
